# # # # # # # # # # # # # # # # # # # # # 
#       #           #           #       # 
# # #   #   # # #   #   # # #   #   # # # 
#       #       #   #       #   #       # 
#   # # # # #   #   # # #   #   # # #   # 
#               #   #       #           # 
# # # # # # # # #   #   #   # # # # #   # 
#           #       #   #   #       #   # 
# # # # #   #   # # #   # # #   #   #   # 
#           #       #           #   #   # 
#   # # # # # # #   # # # # #   #   # # # 
#   #           #   #       #   #       # 
#   #   # # #   #   #   #   # # # # #   # 
#   #   #   #   #       #               # 
#   #   #   #   # # # # # # # # # # #   # 
#   #       #   #                   #   # 
#   # # #   #   #   #   # # # # # # #   # 
#           #   #   #           #       # 
#   # # # # #   #   # # # # #   #   # # # 
#           #               #           # 
# # # # # # # # # # # # # # # # # # # # # 
