# # # # # # # # # # # # # # # # # # # # # 
#           #       #       #           # 
#   #   # # #   # # #   #   # # #   #   # 
#   #   #           #   #   #       #   # 
#   #   #   # # # # #   # # # # # # #   # 
#   #       #   #       #       #       # 
#   # # # # #   #   # # #   # # #   #   # 
#       #       #           #       #   # 
#   # # #   # # #   # # # # # # # # #   # 
#           #                           # 
# # #   # # # # #   # # # # # # #   # # # 
#                           #   #       # 
#   #   # # # # # # # # # # #   # # # # # 
#   #           #       #   #       #   # 
# # #   # # # # #   # # #   #   #   #   # 
#           #   #           #   #       # 
#   # # #   #   #   #   # # #   #   #   # 
#       #           #   #   #   #   #   # 
#   #   # # #   # # #   #   #   # # #   # 
#   #       #       #           #       # 
# # # # # # # # # # # # # # # # # # # # # 
