# # # # # # # # # # # 
#   #       #       # 
#   #   # # # # #   # 
#                   # 
# # # # #   # # #   # 
#   #       #       # 
#   #   # # # # #   # 
#           #   #   # 
# # #   # # #   #   # 
#               #   # 
# # # # # # # # # # # 
