# # # # # # # # # # # 
#   #               # 
#   # # # # #   #   # 
#       #       #   # 
# # #   #   # # # # # 
#       #           # 
#   # # #   # # #   # 
#   #       #       # 
#   # # # # #   #   # 
#               #   # 
# # # # # # # # # # # 
